# total 373
# hand shape \t stroke property


SPs	HandShapeEasilyChunkable

SPs-Rs	HandShapeEasilyChunkable
SPs-Rs-Ms	HandShapeEasilyChunkable
SPs-Rs-Ms-Is	HandShapeEasilyChunkable
SPs-Rs-Ms-Il	HandShapeEasilyChunkable
SPs-Rs-Ms-Iu	HandShapeImpossiblyHardChunkable
SPs-Rs-Ms-SIs	HandShapeEasilyChunkable
SPs-Rs-Ms-SIl	HandShapeEasilyChunkable
SPs-Rs-Ms-SIu	HandShapeImpossiblyHardChunkable
SPs-Rs-Ml	HandShapeEasilyChunkable
SPs-Rs-Ml-Is	HandShapeEasilyChunkable
SPs-Rs-Ml-Il	HandShapeEasilyChunkable
SPs-Rs-Ml-Iu	HandShapeImpossiblyHardChunkable
SPs-Rs-Ml-SIs	HandShapeHardChunkable
SPs-Rs-Ml-SIl	HandShapeEasilyChunkable
SPs-Rs-Ml-SIu	HandShapeImpossiblyHardChunkable
SPs-Rs-Mu	HandShapeEasilyChunkable
SPs-Rs-Mu-Is	HandShapeEasilyChunkable
SPs-Rs-Mu-Il	HandShapeEasilyChunkable
SPs-Rs-Mu-Iu	HandShapeImpossiblyHardChunkable
SPs-Rs-Mu-SIs	HandShapeEasilyChunkable
SPs-Rs-Mu-SIl	HandShapeEasilyChunkable
SPs-Rs-Mu-SIu	HandShapeImpossiblyHardChunkable
SPs-Rs-Is	HandShapeEasilyChunkable
SPs-Rs-Il	HandShapeEasilyChunkable
SPs-Rs-Iu	HandShapeEasilyChunkable
SPs-Rs-SIs	HandShapeEasilyChunkable
SPs-Rs-SIl	HandShapeEasilyChunkable
SPs-Rs-SIu	HandShapeEasilyChunkable

SPs-Ru	HandShapeEasilyChunkable
SPs-Ru-Ms	HandShapeEasilyChunkable
SPs-Ru-Ms-Is	HandShapeEasilyChunkable
SPs-Ru-Ms-Il	HandShapeEasilyChunkable
SPs-Ru-Ms-Iu	HandShapeImpossiblyHardChunkable
SPs-Ru-Ms-SIs	HandShapeEasilyChunkable
SPs-Ru-Ms-SIl	HandShapeEasilyChunkable
SPs-Ru-Ms-SIu	HandShapeHardChunkable
SPs-Ru-Ml	HandShapeEasilyChunkable
SPs-Ru-Ml-Is	HandShapeEasilyChunkable
SPs-Ru-Ml-Il	HandShapeEasilyChunkable
SPs-Ru-Ml-Iu	HandShapeImpossiblyHardChunkable
SPs-Ru-Ml-SIs	HandShapeHardChunkable
SPs-Ru-Ml-SIl	HandShapeEasilyChunkable
SPs-Ru-Ml-SIu	HandShapeImpossiblyHardChunkable
SPs-Ru-Mu	HandShapeEasilyChunkable
SPs-Ru-Mu-Is	HandShapeEasilyChunkable
SPs-Ru-Mu-Il	HandShapeEasilyChunkable
SPs-Ru-Mu-Iu	HandShapeHardChunkable
SPs-Ru-Mu-SIs	HandShapeEasilyChunkable
SPs-Ru-Mu-SIl	HandShapeEasilyChunkable
SPs-Ru-Mu-SIu	HandShapeEasilyChunkable
SPs-Ru-Is	HandShapeEasilyChunkable
SPs-Ru-Il	HandShapeEasilyChunkable
SPs-Ru-Iu	HandShapeEasilyChunkable
SPs-Ru-SIs	HandShapeEasilyChunkable
SPs-Ru-SIl	HandShapeEasilyChunkable
SPs-Ru-SIu	HandShapeEasilyChunkable

SPs-Rl	HandShapeHardChunkable
SPs-Rl-Ms	HandShapeHardChunkable
SPs-Rl-Ms-Is	HandShapeHardChunkable
SPs-Rl-Ms-Il	HandShapeHardChunkable
SPs-Rl-Ms-Iu	HandShapeImpossiblyHardChunkable
SPs-Rl-Ms-SIs	HandShapeHardChunkable
SPs-Rl-Ms-SIl	HandShapeHardChunkable
SPs-Rl-Ms-SIu	HandShapeImpossiblyHardChunkable
SPs-Rl-Ml	HandShapeHardChunkable
SPs-Rl-Ml-Is	HandShapeHardChunkable
SPs-Rl-Ml-Il	HandShapeHardChunkable
SPs-Rl-Ml-Iu	HandShapeImpossiblyHardChunkable
SPs-Rl-Ml-SIs	HandShapeHardChunkable
SPs-Rl-Ml-SIl	HandShapeHardChunkable
SPs-Rl-Ml-SIu	HandShapeImpossiblyHardChunkable
SPs-Rl-Mu	HandShapeImpossiblyHardChunkable
SPs-Rl-Mu-Is	HandShapeImpossiblyHardChunkable
SPs-Rl-Mu-Il	HandShapeImpossiblyHardChunkable
SPs-Rl-Mu-Iu	HandShapeImpossiblyHardChunkable
SPs-Rl-Mu-SIs	HandShapeImpossiblyHardChunkable
SPs-Rl-Mu-SIl	HandShapeImpossiblyHardChunkable
SPs-Rl-Mu-SIu	HandShapeImpossiblyHardChunkable
SPs-Rl-Is	HandShapeHardChunkable
SPs-Rl-Il	HandShapeHardChunkable
SPs-Rl-Iu	HandShapeImpossiblyHardChunkable
SPs-Rl-SIs	HandShapeHardChunkable
SPs-Rl-SIl	HandShapeHardChunkable
SPs-Rl-SIu	HandShapeImpossiblyHardChunkable

SPs-SRs	HandShapeEasilyChunkable
SPs-SRs-Ms	HandShapeEasilyChunkable
SPs-SRs-Ms-Is	HandShapeEasilyChunkable
SPs-SRs-Ms-Il	HandShapeEasilyChunkable
SPs-SRs-Ms-Iu	HandShapeImpossiblyHardChunkable
SPs-SRs-Ms-SIs	HandShapeEasilyChunkable
SPs-SRs-Ms-SIl	HandShapeEasilyChunkable
SPs-SRs-Ms-SIu	HandShapeImpossiblyHardChunkable
SPs-SRs-Ml	HandShapeEasilyChunkable
SPs-SRs-Ml-Is	HandShapeEasilyChunkable
SPs-SRs-Ml-Il	HandShapeEasilyChunkable
SPs-SRs-Ml-Iu	HandShapeImpossiblyHardChunkable
SPs-SRs-Ml-SIs	HandShapeHardChunkable
SPs-SRs-Ml-SIl	HandShapeEasilyChunkable
SPs-SRs-Ml-SIu	HandShapeImpossiblyHardChunkable
SPs-SRs-Mu	HandShapeEasilyChunkable
SPs-SRs-Mu-Is	HandShapeEasilyChunkable
SPs-SRs-Mu-Il	HandShapeEasilyChunkable
SPs-SRs-Mu-Iu	HandShapeImpossiblyHardChunkable
SPs-SRs-Mu-SIs	HandShapeEasilyChunkable
SPs-SRs-Mu-SIl	HandShapeEasilyChunkable
SPs-SRs-Mu-SIu	HandShapeImpossiblyHardChunkable
SPs-SRs-Is	HandShapeEasilyChunkable
SPs-SRs-Il	HandShapeEasilyChunkable
SPs-SRs-Iu	HandShapeEasilyChunkable
SPs-SRs-SIs	HandShapeEasilyChunkable
SPs-SRs-SIl	HandShapeEasilyChunkable
SPs-SRs-SIu	HandShapeEasilyChunkable

SPs-SRl	HandShapeHardChunkable
SPs-SRl-Ms	HandShapeHardChunkable
SPs-SRl-Ms-Is	HandShapeHardChunkable
SPs-SRl-Ms-Il	HandShapeHardChunkable
SPs-SRl-Ms-Iu	HandShapeImpossiblyHardChunkable
SPs-SRl-Ms-SIs	HandShapeHardChunkable
SPs-SRl-Ms-SIl	HandShapeHardChunkable
SPs-SRl-Ms-SIu	HandShapeImpossiblyHardChunkable
SPs-SRl-Ml	HandShapeHardChunkable
SPs-SRl-Ml-Is	HandShapeHardChunkable
SPs-SRl-Ml-Il	HandShapeHardChunkable
SPs-SRl-Ml-Iu	HandShapeImpossiblyHardChunkable
SPs-SRl-Ml-SIs	HandShapeHardChunkable
SPs-SRl-Ml-SIl	HandShapeHardChunkable
SPs-SRl-Ml-SIu	HandShapeImpossiblyHardChunkable
SPs-SRl-Mu	HandShapeImpossiblyHardChunkable
SPs-SRl-Mu-Is	HandShapeImpossiblyHardChunkable
SPs-SRl-Mu-Il	HandShapeImpossiblyHardChunkable
SPs-SRl-Mu-Iu	HandShapeImpossiblyHardChunkable
SPs-SRl-Mu-SIs	HandShapeImpossiblyHardChunkable
SPs-SRl-Mu-SIl	HandShapeImpossiblyHardChunkable
SPs-SRl-Mu-SIu	HandShapeImpossiblyHardChunkable
SPs-SRl-Is	HandShapeHardChunkable
SPs-SRl-Il	HandShapeHardChunkable
SPs-SRl-Iu	HandShapeImpossiblyHardChunkable
SPs-SRl-SIs	HandShapeHardChunkable
SPs-SRl-SIl	HandShapeHardChunkable
SPs-SRl-SIu	HandShapeImpossiblyHardChunkable

SPs-SRu	HandShapeEasilyChunkable
SPs-SRu-Ms	HandShapeEasilyChunkable
SPs-SRu-Ms-Is	HandShapeEasilyChunkable
SPs-SRu-Ms-Il	HandShapeEasilyChunkable
SPs-SRu-Ms-Iu	HandShapeImpossiblyHardChunkable
SPs-SRu-Ms-SIs	HandShapeEasilyChunkable
SPs-SRu-Ms-SIl	HandShapeEasilyChunkable
SPs-SRu-Ms-SIu	HandShapeHardChunkable
SPs-SRu-Ml	HandShapeEasilyChunkable
SPs-SRu-Ml-Is	HandShapeEasilyChunkable
SPs-SRu-Ml-Il	HandShapeEasilyChunkable
SPs-SRu-Ml-Iu	HandShapeImpossiblyHardChunkable
SPs-SRu-Ml-SIs	HandShapeHardChunkable
SPs-SRu-Ml-SIl	HandShapeEasilyChunkable
SPs-SRu-Ml-SIu	HandShapeImpossiblyHardChunkable
SPs-SRu-Mu	HandShapeEasilyChunkable
SPs-SRu-Mu-Is	HandShapeEasilyChunkable
SPs-SRu-Mu-Il	HandShapeEasilyChunkable
SPs-SRu-Mu-Iu	HandShapeHardChunkable
SPs-SRu-Mu-SIs	HandShapeEasilyChunkable
SPs-SRu-Mu-SIl	HandShapeEasilyChunkable
SPs-SRu-Mu-SIu	HandShapeEasilyChunkable
SPs-SRu-Is	HandShapeEasilyChunkable
SPs-SRu-Il	HandShapeEasilyChunkable
SPs-SRu-Iu	HandShapeEasilyChunkable
SPs-SRu-SIs	HandShapeEasilyChunkable
SPs-SRu-SIl	HandShapeEasilyChunkable
SPs-SRu-SIu	HandShapeEasilyChunkable

SPs-Ms	HandShapeEasilyChunkable
SPs-Ms-Is	HandShapeEasilyChunkable
SPs-Ms-Il	HandShapeEasilyChunkable
SPs-Ms-Iu	HandShapeHardChunkable
SPs-Ms-SIs	HandShapeEasilyChunkable
SPs-Ms-SIl	HandShapeEasilyChunkable
SPs-Ms-SIu	HandShapeHardChunkable

SPs-Ml	HandShapeEasilyChunkable
SPs-Ml-Is	HandShapeHardChunkable
SPs-Ml-Il	HandShapeEasilyChunkable
SPs-Ml-Iu	HandShapeImpossiblyHardChunkable
SPs-Ml-SIs	HandShapeHardChunkable
SPs-Ml-SIl	HandShapeEasilyChunkable
SPs-Ml-SIu	HandShapeImpossiblyHardChunkable

SPs-Mu	HandShapeEasilyChunkable
SPs-Mu-Is	HandShapeEasilyChunkable
SPs-Mu-Il	HandShapeEasilyChunkable
SPs-Mu-Iu	HandShapeHardChunkable
SPs-Mu-SIs	HandShapeEasilyChunkable
SPs-Mu-SIl	HandShapeEasilyChunkable
SPs-Mu-SIu	HandShapeHardChunkable

SPs-Is	HandShapeEasilyChunkable
SPs-Il	HandShapeEasilyChunkable
SPs-Iu	HandShapeEasilyChunkable

SPs-SIs	HandShapeEasilyChunkable
SPs-SIl	HandShapeEasilyChunkable
SPs-SIu	HandShapeEasilyChunkable

Ps	HandShapeEasilyChunkable

Ps-Rs	HandShapeEasilyChunkable
Ps-Rs-Ms	HandShapeEasilyChunkable
Ps-Rs-Ms-Is	HandShapeEasilyChunkable
Ps-Rs-Ms-Il	HandShapeEasilyChunkable
Ps-Rs-Ms-Iu	HandShapeImpossiblyHardChunkable
Ps-Rs-Ms-SIs	HandShapeEasilyChunkable
Ps-Rs-Ms-SIl	HandShapeEasilyChunkable
Ps-Rs-Ms-SIu	HandShapeImpossiblyHardChunkable
Ps-Rs-Ml	HandShapeEasilyChunkable
Ps-Rs-Ml-Is	HandShapeEasilyChunkable
Ps-Rs-Ml-Il	HandShapeEasilyChunkable
Ps-Rs-Ml-Iu	HandShapeImpossiblyHardChunkable
Ps-Rs-Ml-SIs	HandShapeHardChunkable
Ps-Rs-Ml-SIl	HandShapeEasilyChunkable
Ps-Rs-Ml-SIu	HandShapeImpossiblyHardChunkable
Ps-Rs-Mu	HandShapeEasilyChunkable
Ps-Rs-Mu-Is	HandShapeEasilyChunkable
Ps-Rs-Mu-Il	HandShapeEasilyChunkable
Ps-Rs-Mu-Iu	HandShapeImpossiblyHardChunkable
Ps-Rs-Mu-SIs	HandShapeEasilyChunkable
Ps-Rs-Mu-SIl	HandShapeEasilyChunkable
Ps-Rs-Mu-SIu	HandShapeImpossiblyHardChunkable
Ps-Rs-Is	HandShapeEasilyChunkable
Ps-Rs-Il	HandShapeEasilyChunkable
Ps-Rs-Iu	HandShapeEasilyChunkable
Ps-Rs-SIs	HandShapeEasilyChunkable
Ps-Rs-SIl	HandShapeEasilyChunkable
Ps-Rs-SIu	HandShapeEasilyChunkable

Ps-Ru	HandShapeEasilyChunkable
Ps-Ru-Ms	HandShapeEasilyChunkable
Ps-Ru-Ms-Is	HandShapeEasilyChunkable
Ps-Ru-Ms-Il	HandShapeEasilyChunkable
Ps-Ru-Ms-Iu	HandShapeImpossiblyHardChunkable
Ps-Ru-Ms-SIs	HandShapeEasilyChunkable
Ps-Ru-Ms-SIl	HandShapeEasilyChunkable
Ps-Ru-Ms-SIu	HandShapeHardChunkable
Ps-Ru-Ml	HandShapeEasilyChunkable
Ps-Ru-Ml-Is	HandShapeEasilyChunkable
Ps-Ru-Ml-Il	HandShapeEasilyChunkable
Ps-Ru-Ml-Iu	HandShapeImpossiblyHardChunkable
Ps-Ru-Ml-SIs	HandShapeHardChunkable
Ps-Ru-Ml-SIl	HandShapeEasilyChunkable
Ps-Ru-Ml-SIu	HandShapeImpossiblyHardChunkable
Ps-Ru-Mu	HandShapeEasilyChunkable
Ps-Ru-Mu-Is	HandShapeEasilyChunkable
Ps-Ru-Mu-Il	HandShapeEasilyChunkable
Ps-Ru-Mu-Iu	HandShapeHardChunkable
Ps-Ru-Mu-SIs	HandShapeEasilyChunkable
Ps-Ru-Mu-SIl	HandShapeEasilyChunkable
Ps-Ru-Mu-SIu	HandShapeEasilyChunkable
Ps-Ru-Is	HandShapeEasilyChunkable
Ps-Ru-Il	HandShapeEasilyChunkable
Ps-Ru-Iu	HandShapeEasilyChunkable
Ps-Ru-SIs	HandShapeEasilyChunkable
Ps-Ru-SIl	HandShapeEasilyChunkable
Ps-Ru-SIu	HandShapeEasilyChunkable

Ps-Rl	HandShapeHardChunkable
Ps-Rl-Ms	HandShapeHardChunkable
Ps-Rl-Ms-Is	HandShapeHardChunkable
Ps-Rl-Ms-Il	HandShapeHardChunkable
Ps-Rl-Ms-Iu	HandShapeImpossiblyHardChunkable
Ps-Rl-Ms-SIs	HandShapeHardChunkable
Ps-Rl-Ms-SIl	HandShapeHardChunkable
Ps-Rl-Ms-SIu	HandShapeImpossiblyHardChunkable
Ps-Rl-Ml	HandShapeHardChunkable
Ps-Rl-Ml-Is	HandShapeHardChunkable
Ps-Rl-Ml-Il	HandShapeHardChunkable
Ps-Rl-Ml-Iu	HandShapeImpossiblyHardChunkable
Ps-Rl-Ml-SIs	HandShapeHardChunkable
Ps-Rl-Ml-SIl	HandShapeHardChunkable
Ps-Rl-Ml-SIu	HandShapeImpossiblyHardChunkable
Ps-Rl-Mu	HandShapeImpossiblyHardChunkable
Ps-Rl-Mu-Is	HandShapeImpossiblyHardChunkable
Ps-Rl-Mu-Il	HandShapeImpossiblyHardChunkable
Ps-Rl-Mu-Iu	HandShapeImpossiblyHardChunkable
Ps-Rl-Mu-SIs	HandShapeImpossiblyHardChunkable
Ps-Rl-Mu-SIl	HandShapeImpossiblyHardChunkable
Ps-Rl-Mu-SIu	HandShapeImpossiblyHardChunkable
Ps-Rl-Is	HandShapeHardChunkable
Ps-Rl-Il	HandShapeHardChunkable
Ps-Rl-Iu	HandShapeImpossiblyHardChunkable
Ps-Rl-SIs	HandShapeHardChunkable
Ps-Rl-SIl	HandShapeHardChunkable
Ps-Rl-SIu	HandShapeImpossiblyHardChunkable

Ps-Ms	HandShapeEasilyChunkable
Ps-Ms-Is	HandShapeEasilyChunkable
Ps-Ms-Il	HandShapeEasilyChunkable
Ps-Ms-Iu	HandShapeHardChunkable
Ps-Ms-SIs	HandShapeEasilyChunkable
Ps-Ms-SIl	HandShapeEasilyChunkable
Ps-Ms-SIu	HandShapeHardChunkable

Ps-Ml	HandShapeEasilyChunkable
Ps-Ml-Is	HandShapeHardChunkable
Ps-Ml-Il	HandShapeEasilyChunkable
Ps-Ml-Iu	HandShapeImpossiblyHardChunkable
Ps-Ml-SIs	HandShapeHardChunkable
Ps-Ml-SIl	HandShapeEasilyChunkable
Ps-Ml-SIu	HandShapeImpossiblyHardChunkable

Ps-Mu	HandShapeEasilyChunkable
Ps-Mu-Is	HandShapeEasilyChunkable
Ps-Mu-Il	HandShapeEasilyChunkable
Ps-Mu-Iu	HandShapeHardChunkable
Ps-Mu-SIs	HandShapeEasilyChunkable
Ps-Mu-SIl	HandShapeEasilyChunkable
Ps-Mu-SIu	HandShapeHardChunkable

Ps-Is	HandShapeEasilyChunkable
Ps-Il	HandShapeEasilyChunkable
Ps-Iu	HandShapeEasilyChunkable

Ps-SIs	HandShapeEasilyChunkable
Ps-SIl	HandShapeEasilyChunkable
Ps-SIu	HandShapeEasilyChunkable

Rs	HandShapeEasilyChunkable

Rs-Ms	HandShapeEasilyChunkable
Rs-Ms-Is	HandShapeEasilyChunkable
Rs-Ms-Il	HandShapeEasilyChunkable
Rs-Ms-Iu	HandShapeHardChunkable
Rs-Ms-SIs	HandShapeEasilyChunkable
Rs-Ms-SIl	HandShapeEasilyChunkable
Rs-Ms-SIu	HandShapeHardChunkable
Rs-Ml	HandShapeEasilyChunkable
Rs-Ml-Is	HandShapeEasilyChunkable
Rs-Ml-Il	HandShapeEasilyChunkable
Rs-Ml-Iu	HandShapeImpossiblyHardChunkable
Rs-Ml-SIs	HandShapeHardChunkable
Rs-Ml-SIl	HandShapeEasilyChunkable
Rs-Ml-SIu	HandShapeImpossiblyHardChunkable
Rs-Mu	HandShapeEasilyChunkable
Rs-Mu-Is	HandShapeEasilyChunkable
Rs-Mu-Il	HandShapeEasilyChunkable
Rs-Mu-Iu	HandShapeHardChunkable
Rs-Mu-SIs	HandShapeEasilyChunkable
Rs-Mu-SIl	HandShapeEasilyChunkable
Rs-Mu-SIu	HandShapeHardChunkable
Rs-Is	HandShapeEasilyChunkable
Rs-Il	HandShapeEasilyChunkable
Rs-Iu	HandShapeEasilyChunkable
Rs-SIs	HandShapeEasilyChunkable
Rs-SIl	HandShapeEasilyChunkable
Rs-SIu	HandShapeEasilyChunkable

SRs	HandShapeEasilyChunkable

SRs-Ms	HandShapeEasilyChunkable
SRs-Ms-Is	HandShapeEasilyChunkable
SRs-Ms-Il	HandShapeEasilyChunkable
SRs-Ms-Iu	HandShapeHardChunkable
SRs-Ms-SIs	HandShapeEasilyChunkable
SRs-Ms-SIl	HandShapeEasilyChunkable
SRs-Ms-SIu	HandShapeHardChunkable
SRs-Ml	HandShapeEasilyChunkable
SRs-Ml-Is	HandShapeEasilyChunkable
SRs-Ml-Il	HandShapeEasilyChunkable
SRs-Ml-Iu	HandShapeImpossiblyHardChunkable
SRs-Ml-SIs	HandShapeHardChunkable
SRs-Ml-SIl	HandShapeEasilyChunkable
SRs-Ml-SIu	HandShapeImpossiblyHardChunkable
SRs-Mu	HandShapeEasilyChunkable
SRs-Mu-Is	HandShapeEasilyChunkable
SRs-Mu-Il	HandShapeEasilyChunkable
SRs-Mu-Iu	HandShapeHardChunkable
SRs-Mu-SIs	HandShapeEasilyChunkable
SRs-Mu-SIl	HandShapeEasilyChunkable
SRs-Mu-SIu	HandShapeHardChunkable

SRs-Is	HandShapeEasilyChunkable
SRs-Il	HandShapeEasilyChunkable
SRs-Iu	HandShapeEasilyChunkable
SRs-SIs	HandShapeEasilyChunkable
SRs-SIl	HandShapeEasilyChunkable
SRs-SIu	HandShapeEasilyChunkable

Ms	HandShapeEasilyChunkable

Ms-Is	HandShapeEasilyChunkable
Ms-Il	HandShapeEasilyChunkable
Ms-Iu	HandShapeHardChunkable
Ms-SIs	HandShapeEasilyChunkable
Ms-SIl	HandShapeEasilyChunkable
Ms-SIu	HandShapeHardChunkable

Is	HandShapeEasilyChunkable

SIs	HandShapeEasilyChunkable
